14 20
#..#.#..#.#..#.#..#.
#...##..#.#....#..#.
....#..#.##.##.#..#.
#...##..#.#.#....##.
##.S#..#.##..###..#.
#....#..#.#..#.#..#.
##..##..#.#..#.#..#.
.##.#.....#.##....#.
#...##.##.#..#....#.
##..#...#..#.#.#..#.
#..#.#..#.#..###..#.
#...##..#....#.#..#.
.......#.##..#E#..#.
#...##..#....#....#.


